20;10;32
5 5 5 5 5 5 5 5 5 5 5 5 5 5 5 5 5 5 5 5
5 . . . 0 . . . . . . . . . 0 . . . . 5
5 . . . . . . . . 1 . . . . . . . . . 5
5 . . . . . 1 . . . . . . . . . 1 . . 5
5 . . . . . . . . . . . . . . . . . . 5
5 5 5 5 . 5 5 5 5 5 . . . . . . . . . 5
5 . . . . . . . . 5 . . . . 1 . . . . 5
5 . . . . . . . . 5 0 1 . . . . . . . 5
5 . . . . . . . . 5 . . . . . . . . . 5
5 5 5 5 5 5 5 5 5 5 5 5 5 5 5 5 5 5 5 5
#
0;3;3
1;18;7
1;14;2
1;12;4
1;4;7
2;1;1
#
